
[Hobbies]
Flowerpressing: Топтание цветов
Fishing: Рыболовство
CollectingfineBongoolianMucusWine: Коллекционирование бонгулианского слизистого вина
Collectingsmallmodelreptoids: Коллекционирование небольших моделей рептоидов
Starshipspotting: Обнаружение кораблей
Antigravitycooking: Антигравитационная кухня
Playingspaceguitar: Игра на космической гитаре
Miniaturespace-wargaming: Игра в миниатюрные звёздные войны
Asteroidclimbing: Астероидный альпинизм
Antigravitydancing: Антигравитационные танцы
Inventingthings: Изобретательство
Weaponsresearch: Разработка оружия
Meteorracing: Гонки на метеоритах
Cybernetics: Кибернетика
Ancientlanguages: Древние языки
Playingvideogames: Видеоигры
TakingcareoflostMemau: Забота о потерянных мимау
PolishingSkrasherchitin: Полировка хитина скрашеров
BreedingYabberjacks: Разведение ябберджеков
Photographingblackholes: Фотографирование чёрных дыр
Buildingmodelstarships: Построение модельных кораблей
EnvironmentalIssues: Защита окружающей среды
Politics: Политика
WatchingZ-ratedfilms: Просмотр низкорейтинговых фильмов
Solarsurfing: Солнечный сёрфинг
Chasingcomets: Охота за кометами
Catchingfallingstars: Ловля падающих звезд
Diningout: Ужины в ресторанах
Goingboldlywherenoalienhasgonebefore: Бывать там, где прежде не ступала нога инопланетянина
Duellingwithlaserswords: Дуэли на лазерных мечах
BreedingSpawn: Разведение грибов
Ponderingtheanswertotheultimatequestion: Поиск ответа на основной вопрос
Restoringolddroids: Восстановление старых роботов
HuntingGlaoths: Охота на глаотов
SpreadingthewordofZedem: Распространение слова Зедема
SavingthePhinray: Уход за финреем
Collectingspacerocks: Коллекционирование космических камней
Solarsailing: Плавание под солнечным парусом
Hitch-hikingacrosstheGalaxy: Путешествие автостопом по галактике
Growingbonsaiplanets: Выращивание карликовых планет
ListeningtothespacerockbandTheRollingAsteroids: Прослушивание рок-группы Роллинг Астероидз
ListeningtothespacerocklegendBruceWarpsteen: Прослушивание рок-легенды Брюса Варпстина
CountingthenumberofstarsintheMungoidNebula: Подсчёт звёзд в Кашевидной туманности
Listeningtothemusicofthespheres: Слушать музыку сфер
Tryingtoaudiblyscreaminspace: Пытаться слышно крикнуть в космосе
Collectingthetinyplastictablesyougetinpizzaboxes: Коллекционирование одноразовых пластиковых подставок из-под пиццы
PractisingZed-fu: Совершенствование в Зед-Фу
Groovingondowntothefunkyspacebeat: Ловить кайф от фанкового космического бита
Watchingpaintdry: Смотреть как высыхает краска
BitingoffmorethanIcanchew: Откусывать больше, чем можно прожевать
CollectingusedSirenunderwear: Коллекционирование перьев из крыльев сирен
Collectingsecondhandtoiletpaper: Коллекционирование б/у сказзеров
Collectingsphinctergasesforlaterenjoyment: Сбор веселящего газа для дальнейшего наслаждения
Watchingkettlesboil: Наблюдение за кипящим чайником
PlayingUrbanChaosfromMuckyFoot: Играть в Урбан Хаос от Маки Фут
Zero-gweightlifting: Поднятие тяжестей в условиях невесомости
Lickingwindows: Облизывать окна
Shootingstars: Стрельба по звёздам
Bogsnorkelling: Болотное ныряние с маской
Muffdiving: Погружение в Глубокое море спокойствия
Buildinglogcabins: Строительство хижин из бревен
Cablelaying: Прокладка кабеля
Uphillgardening: Катание на водных лыжах
Interiordecorating: Оформление помещений
HorizontalHorticulture: Горизонтальное садоводство
Whistlinginthedark: Свист во тьме
Trufflehunting: Охота за трюфелями
Monkeyspanking: Охота на гома
Playingthepinkoboe: Играть в музыкальных группах Кантины
Psychedelicyodelling: Психоделические йодли
Astronomy: Астрономия
Geography: География
ParticlePhysics: Физика частиц
Journalism: Журналистика
Passingthetimeofday: Убивание времени
Spreadinggossip: Распространение сплетен
Swimming: Плавание
Bottomburpingcompetitions: Соревнования по отрыжке
Collectingtoenailclippings: Коллекционирование обрезков ногтей
Proboscispicking: Собирательство хоботом
PrayingtoOrbastangtheSunGod: Поклонение Орбастангу, богу солнца
Chillingoutwithfriends: Болтовня с друзьями
Drinkingvastquantitiesofspacebooze: Поглощение больших количеств космического сока
Practicaljokes: Шутки на практике
Beinghappy: Быть счастливым
Omnicycling: Езда на омницикле
Collectingexoticweaponry: Коллекционирование экзотического оружия
Tombraiding: Расхищение гробниц
ReadingNationalGeomorphicMagazine: Чтение журналов "Нейшенел геоморфик"
LearningTelepathy: Изучение телепатии
BecomingonewiththeMultiverse: Соеденение в одно целое с мультивселенной
Quantumleaping: Квантовые прыжки
Travellingfasterthanlight: Путешествие со скоростью выше скорости света
Scaringyoungpodlings: Пугание юных подлингов
Runningahydroponicfarm: Гидропоническая ферма
Namingminorstars: Придумывать имена мелким звёздам
Wormholesurfing: Сёрфинг в червоточинах
Listeningforpeoplescreaminginspace: Слушать крики людей в космосе
Waitingforthenextbigbang: Ожидание следующего Большого взрыва
TellingjokesaboutEarthlings: Рассказывать анекдоты про землян
GrievingforrelativeslostatRoswell: Тоска по родственникам, потерянным в Розуэлле
Abductingpeople: Похищение людей
Mutilatingcattle: Калеченье крупного рогатого скота
HoveringoverMexicoCity: Парение над Мехико в летающей тарелке
Irritatingthemilitary: Надоедание военным
Mindmelding: Объединяться разумами
Warping: Деформация
Evolving: Эволюционирование
Spiritualenhancement: Духовное совершенствование
Decodingradiowaves: Декодирование радиоволн
LaughingaboutSETI: Подшучивание над СЕТИ
Poetry: Поэзия
Growingbileworms: Выращивание желчных червей

